##############################################################
#     #   #      # #   #         # #    #         # #   ##   #
# ## #  ##  # # #    ##  ## ## # #   # #  # #### #    #   ## #
##   # ### ##  #  # #   ## #   #  # #   ##  #   #  ### ##  # #
#  ##   #    #   #### ###  # ##  #  # # #  #  #   #      # # #
# #   ##  ##### # #       #    #  # # #   #  ### ## ## ##  # #
#  ##    #   #  #   ##### # # #  #  #  ## # ###  #  ##    #  #
## ## # #  # # #  ##    ##   #  # # ## # #   #  #  #  #### # #
##   #  # ## #   ### ##   # #  #  #  #     ##  #  ## #   #   #
# ##  ##  #   ##  #  # ##   # #  ###  ## #### #  #     #  # ##
#  ##   # # # # # # #    ###  # # # #   #  #  # #  # ##  #   #
##   ## #  #  #   #   ##   # #  #    ##   #  ## ##  # # #  ###
### # # ## # # ### # #   # #  # # # ## ## # ##     #  # ##   #
##    #  # #        #  # #  # #   #    #  #   #####  #   # # #
#  # #  #   ####### #### # #  # ## # ##  # ## #     # ## ##  #
# # #  #  ##      #     #   # #    #    #   #  ## ##   #    ##
#   # #  ##  # ##  ## # # # #  ##### # ## # ##  #    #  # #  #
# ##  ##   # #   #   #  # #  # #    #    #    # # # # # #  # #
# #  #   #  ## #  ## # #   # #   ##  ### #### # # ##  #  # # #
#  #  # # # #   #  ###  # #   ###  # #        # #   #  #  #  #
##  # #   #  ##  #     #  # ##   # # ### # ## #  ##  #  #  # #
#  #   # # # # #  ##### ##  #  #   #    # #   # #  #  #  #   #
# #  #  #    #  # #        #  # # # # # # # ##  # ###  #  ####
#   # # # #### ##   ##### # #   #    #  # #  # #   #  #  ##  #
# ###  #  #      ###     #   ##  ## #  #   # # # #  # ##    ##
#    #   # ## # #    # #   #  # #    # ## #  # # ## #    ##  #
#### # # #    #  # #  # # ### ##  # #   #   #  #  ## # ##   ##
#    # # # ### #  #  #  #  #    #  #  #  # ## ###     #   ## #
## ## #  #   #   ## #  #  #  ##   #  # #  #   ### ## #  ###  #
#   #   ## #  ###   ##  #  ## ####  #   # ## # #   # # #   # #
# #   ##    #     #    ###         #  #      #   # #     #   #
##############################################################
